NO assets/textures/backroom.xpm
SO assets/textures/backroom.xpm
WE assets/textures/backroom.xpm
EA assets/textures/backroom.xpm

F 150,142,60
C 191,184,89

1111111111111111111111111111111111111111111111111111111
1000000000000000000000000000000000001000000000000000001
1011111111111111111111111111111111101011111111111111101
1010000000000000000000000000000000001000000000000000101
1010111111111111111111111111111111111111111111111110101
1010100000000000000000000000000000000000000000000010101
1010101111111111000000000000000001111111111011111010101
1010101000000001000000000000000001000000001010001010101
1010101011111101001111111111111001011111101010101010101
1010101010000001001000000000001001010000101010101010101
1010101010111111001010101010101001010110101010101010101
1000100010000000001000000000001000000010100010100010001
1110111011111111111010101010101111111110111110111011111
1000000000000000001000000000001000000000000000000000001
1011111111101111111010101010101111111011111111101111101
1000000000101000000000000000000000001010000000001000001
1011111110101011111010101010101111101010111111101011101
1010000010101010001000000000001000101010100000101010101
1010111010101010101010101010101010101010101110101010101
1010100010000000101000000000001010000000100010100010101
1010101111111111101111111111111011111111111010111110101
1010000000000000000000000000000000000000000010000000101
1011111111111111111111111111111111111111111111111111101
1000000000000000000000000000000000000000000000000000001
1011111101111111111111111111111111111111111011111101111
1010000000000001000000000000001000000000001010000000001
1010111111111101011111101111101011111111101010111111101
1010000000000101010000000000101010000000101010000000001
1011111111110101010111111101010101111110101011111111111
10000000000000010000000000000001000000000000000000000W1
1111111111111111111111111111111111111111111111111111111
